#################################################
## ########     ###############    #########   G#
##       ######     ########### ## ######### ####
## #### ####### ###        #### ##     ##### # ##
## ##   ##      ###### ### #### ###### ##### # ##
## #### ####### ##     ###    # ######       #  #
#   ##    ##### ###### ######   ############### #
### #### ###### ## ###     #############      # #
###   #######   ##   ########   #        #### # #
### # ####### ######          # # ###### #### # #
### # ##    #      ### ######## # ##        #   #
##### ## ######### ###       ##   ### ##### #####
#                  ###### ########### ##### #####
# ################ ###### ################# #####
# #    #           ####           ###       #####
# ## # # #########      #########  ## ######### #
# ## # # # ######################             # #
# ## #   #                      # ########### # #
########## ###################### ########### # #
#    #           #        #                     #
#### ####### ####### # ############### ##########
## # #             # #           #              #
## # ############### ########### ############## #
#S                                              #
#################################################