###############################################################################
#############        ###########      ##G##                                  ##
#              ####               ##     ####  ##################  ########  ##
#  ##########################################       #####  ######      ####  ##
#  ##                                    #############        #############  ##
#  ##  ################################                 ####           ####  ##
#  ##  ##############################################################  ####  ##
#  ##  ##                                                 ###########  ##    ##
#  ##  ##  ################  ###########################  ###########  ##  ####
#  ##  ##  ##                            #####  ######    ##           ##  ####
#  ##  ##  ##  ############  ##########             ####  ##  ###########  ####
#  ##  ##  ######  ##  ###########################  ####  ##  ####         ####
#  ##  ##                                   ##  ##  ####  ##  ####  ###########
#  ##  ###################################  ##  ##  ####  ##                 ##
#  ##           ##########################  ##      ####  #################  ##
#  ###########  #####         ########      ########  ##  #################  ##
#  #######      #####  #####      ####  ############  ##  #################  ##
##  ######  #########  #####  ########          ####  ##                 ##  ##
##  ######  ##         #####  ########  ##  ########  ##  #############  ##  ##
##  ######  ##  #######                 ##      ####  ##  #############  ##  ##
##  ######  ##  ####  ##################  ########        #############  ##  ##
##  ######  ##  ####  ##################  ######  #####################  ##  ##
##      ##  ##                                    #####################  ##  ##
######      ##  ##  ##  #########  #####  ######                    ###  ##  ##
####  ######  ##  ##  ##  ########################################  ###  ##  ##
###                                           ##              ####  ###  ##  ##
###  #######################################  ##  ##########  ####  ###  ##  ##
###  ###########                              ##  ##      ##    ##  ###  ##  ##
###       ########  ############  ####  ########  ##  ##  ####  ##  ###  ##  ##
########        ##  ####      ##  ######          ##  ##  ##    ##  ###  ##  ##
########  ####  ####      ######  ##  ##############  ##  ##  ####  ###      ##
#S        ####        ##########                      ##            ###########
###############################################################################