###############################################################################
#G                                                                            #
##########  ######################################  ########################  #
##########  ########  ####  ####  ################  ########################  #
##########  ########  ####  ####  ################  ####    ##        ######  #
##########  ########  ####  ####  ################  ####  ####  ####  ######  #
##########  ##                ##              ####  ####  ####  ####  ######  #
##########  ########  ####  ####  ##############      ##  ####  ############  #
##########  ########  ####  ####  ######################  ####  ############  #
##########  ########  ##########  ######################  ####  ############  #
##########                                                                ##  #
##########  ####################  ##################################  ######  #
##########  ####################  ####################  ##  ########  ######  #
##########  ########  ##########  ####################  ##  ########  ######  #
####        ########  ##########  ################  ##  ##  ########  ######  #
##########  ########  ##########  ################  ##  ##            ######  #
##########  ########                                ##  ####################  #
######################################################  ####################  #
##                                                                            #
##  ######  ##############  ##########  ############  ##################  #####
##  ######  ##      ######  ##########    ##########  ##################  #####
##  ######  ######  ######  ########  ##  ##########                ####  #####
##  ######  ######  ######  ########  ##  ##########  ############  ####  #####
##  ######  ######      ##  ########  ############            ####  ####  #####
##  ######  ######  ##  ##  ########  ##############  ############  ####  #####
##  ######  ######  ##  ##            ######  ######  ##  ########  ####  #####
##  ######          ##  ##  ############                  ########  ####  #####
##  ##################  ######  ####  ##  ######  ##########        ####  #####
##  ##########################  ####  ##################################  #####
##  ##                                                                    #####
##  ################  ########################  ######  ################  #####
##  ################  ########################  ######  ################  #####
##  ####  ####################          ######  ######  ######  ########  #####
##  ####          ############  ##############  ######  ######  ########  #####
##  ####  ####################  ##############  ######  ######        ##  #####
##  ####  ##                    ##############        ########  ####  ##  #####
##  ##    ##  ##############  ######  ############  ######      ####  ##  #####
##  ##  ####  ##############  ##      ########################  ####  ##  #####
##  ####  ##  ##############  ##  ####                            ##  ##  #####
##  ##  ####  ##############  ##  ####  ########################  ##  ##  #####
##  ########  ##############      ####  ############################  ##  #####
##  ########  ##############  ##  ####  ##########  ####################  #####
##  ########  ##              ##  ####  ##                          ####  #####
##  ########  ##############  ##  ####  ##  ##########  ####  ####  ##    #####
##  ########  ##############  ########  ##  ##########  ####  ####  ####  #####
##  ########  ########################  ##  ######  ##  ####  ####  ####      #
#                                                   ##  ####  ####  ###########
#S##########  ######################  ############    ######  ####            #
###############################################################################