#####################
# #     #         ###
#   # #   # ### # ###
# ### #####     # # #
#   #     # # ### # #
## ##### # #     #  #
# # #     #    ## # #
# # # ##### ## ##   #
#     #     #      ##
# ##### ####### # ###
# #   # #           #
# # ### # # # ## ## #
# # #   #     #   # #
#   # ####### #     #
###  #     # # # # ##
#    # # #   # # # ##
#S # # # ### #     G#
#####################