###########################################################################################
##    ############  ######      ####          ######        ########          #############
####  ######                ##  ##########  ########  ##############  ############  #######
####          ####  ##########  ##########  ##              ########  ####      ##  #######
################  ############          ##      ####  ####  ##        ####  ##  ##  #######
##########  ####  ############  ######  ############  ####  ##  ####        ##  ##  ##  ###
##########  ####  ############  ####    ############  ####  ##  ####  ####  ######  ##  ###
##########                  ##  ##    ####            ####  ##  ####  ####          ##  ###
################  ####  ##  ##  ##  ######  ##############      ####  ####  ##########  ###
##          ####  ####  ##  ##  ##  ######  ##############  ##  ####  ####    ########  ###
##  ######  ####  ####  ##      ##          ##############  ########  ######            ###
##  ######  ####  ####  ##  ##  ##################            ######  ################  ###
##  ######        ####  ##  ######################  ########  ######                ##  ###
##  ############  ####  ####        ##########          ####  ####################  #######
##  ##        ##  ####  ####  ####################  ##  ####  ######                #######
##  ##  ####  ##  ####  ####  ##                    ##  ####  ######  #####################
##  ##  ####  ##  ####  ####    ########  ############  ####  ######                #######
##  ##  ##    ##  ####  ######  ########  ############  ####  ####################  #######
##  ##  ##  ####  ####  ######                ########  ############                #######
##  ##  ##  ####  ####      ############  ####          ############  #####################
##  ######  ####  ######  ####################  ####################                ##  ###
##  ######  ####  ######  ##############  ####  ##################################  ##  ###
##          ####  ######        ########  ####  ############  ####                        #
################  ############    ######  ####  ############      ##  ################  ###
################  ##############  ######  ####  ############  ######                ##  ###
################  ##############  ##            ############  ####################  ##  ###
####                      ######  ##  ############                    ############  ##  ###
####  ##############################  ##########    ######  ##  ####  ####    ####  ##   G#
#S    ############  ##########            ######  ########  ##  ####  ####  ######  #######
###########################################################################################