###########################################################################################
##    ############  ######      ####          ######        ########          #############
####  ######                ##  ##########  ########  ##############  ############  #######
####          ####  ##########  ##########  ##              ########  ####      ##  #######
################  ############          ##      ####  ####  ##        ####  ##  ##  #######
##########  ####  ############  ######  ############  ####  ##  ####        ##  ##  ##  ###
##########  ####  ############  ####    ############  ####  ##  ####  ####  ######  ##  ###
##########                  ##  ##    ####            ####  ##  ####  ####          ##  ###
################  ####  ##  ##  ##  ######  ##############      ####  ####  ##########  ###
##          ####  ####  ##  ##  ##  ######  ##############  ##  ####  ####    ########  ###
##  ######  ####  ####  ##      ##          ##############  ########  ######            ###
##  ######  ####  ####  ##  ##  ##################            ######  ################  ###
##  ######        ####  ##  ######################  ########  ######                ##  ###
##  ############  ####  ####        ##########          ####  ####################  #######
##  ##        ##  ####  ####  ####################  ##  ####  ######                #######
##  ##  ####  ##  ####  ####  ##                    ##  ####  ######  #####################
##  ##  ####  ##  ####  ####    ########  ############  ####  ######                #######
##  ##  ##    ##  ####  ######  ########  ############  ####  ####################  #######
##  ##  ##  ####  ####  ######                ########  ############                #######
##  ##  ##  ####  ####      ############  ####          ############  #####################
##  ######  ####  ######  ####################  ####################                ##  ###
##  ######  ####  ######  ##############  ####  ##################################  ##  ###
##          ####  ######        ########  ####  ############  ####                        #
################  ############    ######  ####  ############      ##  ################  ###
################  ##############  ######  ####  ############  ######                ##  ###
################  ##############  ##            ############  ####################  ##  ###
####                      ######  ##  ############                    ############  ##  ###
####  ##############################  ##########    ######  ##  ####  ####    ####  ##   G#
####  ############  ##########            ######  ########  ##  ####  ####  ######  #######
####  ####  ######  ######      ##############        ####  ##  ####  ####  ######  #######
####  ####  ##              ##  ############    ####  ####  ########                #######
####  ####  ######  ##  ##  ##  ########      ######  ####  ####  ######  ########        #
####  ####  ######  ##  ##  ##  ##########  ########  ####  ####  ######      ######  ##  #
####  ####          ##  ##  ##  ######      ####        ##  ####  ####    ##  ######  ##  #
####  ################  ##  ##  ######  ##  ####  ########  ####  ####  ######        ##  #
####  ################  ##  ##  ##      ##  ####################      ##############  #####
####  ################  ##  ##  ##  ######  ####################  ############  ####    ###
####  ####  ##########  ##  ##  ##    ############                      ######  ######  ###
####  ####  ##########  ##  ##  ####  ############  ############  ########  ##  ###########
####  ####              ##  ##  ######  ##########  ############  ####  ##      ##  #######
##    ##    ##  ##########  ##  ########            ############  ####      ####    #######
##  ##    ####  ##########  ##  ##########  ##  ######    ######  ########  ####  #########
##  ##  ######        ####  ##  ########    ##          ########  ########  ####  ##    ###
##  ##        ######  ########  ########  ############  ########                      #####
##  ########  ######    ######  ########  ############  ##      ######  ######  ####  #####
##  ########  ########    ####  ########  ####################  ######      ##  ####  #####
##  ########  ####  ####  ####  ########                        ##############  ##    #####
##        ##        ##########  ##        ################  ##########  ######  ####  #####
########  ####################  ##########################  ##########            #########
#S        ##########                                    ##  ######      ########         ##
###########################################################################################